XSXXXX
X    X
XXXX X
XX   X
XXEXXX