XXSXXX
XX   X
X XX X
X    X
X XXXX
X    X
XXXXEX